##...#...##
...#...#..#
##.###.####
#..##..##R#
##..C#....#
